s=SELECT 
f=FROM 
w=WHERE
ob=ORDER BY 
sf=SELECT * FROM 
saf=SELECT a.* FROM 
srf=SELECT rowid,a.* FROM 
df=DELETE FROM 
sc=SELECT COUNT(*) FROM 
di=DISTINCT 
u=UPDATE 
td=TO_DATE('','YYYY-MM-DD') 
comit=commit
decl=declare
elseif=elsif
endif=end if
endloop=end loop
except=exception
exitwhen=exit when
form=from
func=function
fuo=for update of
lop=loop
ndf=NO_DATA_FOUND
nil=null
nul=null
pack=package
proc=procedure
rae=RAISE_APPLICATION_ERROR
returns=return
seelct=select
sqlc=sqlcode
sqle=sqlerrm
teh=the
tmr=TOO_MANY_ROWS
wco=where current of
whenothers=when others
whil=while
